. = TileEmpty #phony
# = TileWallBrick #solid #static
@ = TileBoxKidDown #player
s = TileCrateStone

Level
########################
#...#...............####
#.s.#......@..#.......##
#....#.....###........##
##...........#.........#
####...................#
########...............#
########################