. Empty
# TileWallBrick
@ TileBoxKidDown

1
# # # # # # # # # # # # # # # # # # # # # # # #
# # # # # . . . . . . . # . . . . . . . . . . #
# # . . . . . . . . . . . . . . . . . . . . . #
# # . # . . . . . . # . # . . . . . . @ . . . #
# # . # . . . . . . . # . . . . . . . . . . . #
# # . . . . . . . . . . . . . . . . . . . . . #
# # # # # . . . . . . . . . . . . # . . . . . #
# # # # # # # # # # # # # # # # # # # # # # # #
